##########
#Su#uuuuu#
##u#u#u###
##+uu#u+u#
####u#####
#uuuuuuu+#
##u#######
##u#+#####
##uuuuuuF#
##########