2222222222
2102000002
2222020222
2240020402
2222022222
2000000042
2202222222
2202422222
2200000082
2222222222