222222222222222
212000000000002
200020222202022
222220224202042
200000220202222
202202200000002
202202222222222
222200000000022
242202222022022
200002400020022
222222222220222
200000000000222
202222222222222
200000040000082
222222222222222