###############
#S#uuuuuuuuuuu#
#uuu#u####u#u##
#####u##+#u#u+#
#uuuuu##u#u####
#u##u##uuuuuuu#
#u##u##########
####uuuuuuuuu##
#+##u####u##u##
#uuuu#+uuu#uu##
###########u###
#uuuuuuuuuuu###
#u#############
#uuuuuu+uuuuuF#
###############