2 2 2 2 2
2 1 2 8 2
2 0 2 0 2
2 0 4 0 2
2 2 2 2 2