2 2 2 2 2
2 0 2 8 2
2 0 2 0 2
2 4 0 4 2
2 2 2 2 2